-= Cool =-
8	; xl
8	; yl
2	; players
8	; points

111.....
111.....
11......
...  ...
...  ...
......22
.....222
.....222

222.....
222.....
22......
...  ...
...  ...
......11
.....111
.....111