Классика
8	; xl
8	; yl
2	; players
9	; points
; From
111.....
111.....
111.....
........
........
.....222
.....222
.....222
; To
222.....
222.....
222.....
........
........
.....111
.....111
.....111