8х8 (4 игрока)
8	; xl
8	; yl
4	; players
9	; points

111..333
111..333
111..333
........
........
444..222
444..222
444..222

222..444
222..444
222..444
........
........
333..111
333..111
333..111