Классика 10x10
10	; xl
10	; yl
2	; players
15	; points
; From
11111.....
1111......
111.......
11........
1.........
.........2
........22
.......222
......2222
.....22222
; To
22222.....
2222......
222.......
22........
2.........
.........1
........11
.......111
......1111
.....11111