Кто быстрее ?
13	; x
13	; y
4	; players
9	; points
; From
             
 222.....333 
 222.....333 
 222.....333 
 ........... 
 ....   .... 
 ....   .... 
 ....   .... 
 ........... 
 111.....444 
 111.....444 
 111.....444 
            
; To
             
 111.....222 
 111.....222 
 111.....222 
 ........... 
 ....   .... 
 ....   .... 
 ....   .... 
 ........... 
 444.....333 
 444.....333 
 444.....333 
            