Треугольник
8	; xl
8	; yl
2	; players
10	; points

1111....
111.....
11......
1.......
.......2
......22
.....222
....2222

2222....
222.....
22......
2.......
.......1
......11
.....111
....1111